NO ../Cub3d/textures/eagle.png
SO ../Cub3d/textures/greystone.png
WE ../Cub3d/textures/wood.png
EA ../Cub3d/textures/redbrick.png

F 220,100,0
C 225,30,0


1111111111111111111111111
100S00000000000000000001
1010010001110000000000001
10000000000000000000000011111111
10100000000000001110000000000001
10000000001110001110111111111111
1000010000000000010001
10000000000000011101011111111
11000000110101011100000010001
10000000000000001100000010001
100000000000000001101010010001
1100000111010101111101111010111
111101111110101101111010001
111111111111111111111111111