NO ../Cub3d/textures/eagle.png
SO ../Cub3d/textures/greystone.png
WE ../Cub3d/textures/wood.png
EA ../Cub3d/textures/redbrick.png

F 220,100,0
C 225,,30,0
1111111111111111111111111
10000S000000000000000001
1010010001110000000000001
10000000000000000000000011111111          11111
1010000000000000111000000000000111111 1111110001
100000000011100011101111111111111         11111
1000010000000000010001
111111111111111111111
111111111111111111111111
10000000000000011101011111111
11111111111111111111111
11111111111111111111111111111
11000000110101011100000010001
10000000000000001100000010001
10000000000000001101010010001
110000011101010111110111100111
11110111 1110101 101111010001
11111111 1111111 111111111111