NO ../Cub3d/textures/eagle.png
SO ../Cub3d/textures/greystone.png
WE ../Cub3d/textures/wood.png
EA ../Cub3d/textures/redbrick.png

F 220,100,0
C 225,30,0

1111111111111111111111111
10000S000000000000000001
1010010001110000000000001
10000000000000000000000011111111
10100000000000001110000000000001
10000000001110001110111111111111
1000010000000000010001
10000000000000011101011111111
11000000110101011100000010001
10000000000000001100000010001
10000000000000001101010010001
11000001110101011111011110N0111
11110111 1110101 101111010001
11111111 1111111 111111111111