F 220,100,0
C 225,30,0

NO ../Cub3d/textures/eagle.png
SO ../Cub3d/textures/greystone.png
WE ../Cub3d/textures/wood.png
EA ../Cub3d/textures/redbrick.png


1111111111111111111111111
100000000000000000000001
1010000001110000000010001
1000000S000000000000010011111111
10100000000000001110000000000001        
1000000000111000111011111111111111    
100001001100000000010001            
10000000000000011101011111111
11111111111111111111111
11111111111111111111111111111
11000000110101011100000010001
10000000000000001100000010001
10000000000000001101010010001
110000011101010111110111100111
11111111 1110101 101111010001
1111 1 111111111111111111111
