NO ./path_to_the_north_texture
SO ./path_to_the_south_texture
WE ./path_to_the_west_texture
EA ./path_to_the_east_texture

F 220,100,0
C 225,30,0


1111111111111111111111111
100000000011000000000001
101000S001110000000000001
1001000000000000000000001
111000000011000001110000000000001
10000000001110001110111111111111
11110111111111011100000010001
11110111111111011101010010001
11000000110101011100000010001
10000000000000001100000010001
100000000000000001101010010001
1100000111010101111101111010111
111101111110101101111010001
111111111111111111111111111