NO ./path_to_the_north_texture
SO ./path_to_the_south_texture
WE ./path_to_the_west_texture
EA ./path_to_the_east_texture

F 220,100,0
C 225,30,0


1111111111111111111111111
100E00000000000000000001
1010010001110000000000001
1000000000000000000000001
10100000000000001110000000000001
10000000001110001110111111111111
1000010000000000010001
10000000000000011101010010001
11000000110101011100000010001
10000000000000001100000010001
100000000000000001101010010001
1100000111010101111101111010111
111101111110101101111010001
111111111111111111111111111